20 11 0 0
1 6 1 1 1 1 1 1 1 1 1 1 6 1 1 1 1 1 1 1
1 1 1 1 1 1 6 1 1 1 1 1 1 1 1 1 1 1 6 1
1 1 1 1 1 1 1 1 1 1 1 1 1 1 1 1 1 1 2 2
1 1 1 1 1 1 1 1 1 1 1 1 1 1 1 1 1 2 5 5
1 1 1 1 4 4 4 4 4 4 4 4 4 4 4 4 4 5 5 5
3 3 3 3 3 3 3 3 3 3 3 3 3 3 3 3 5 5 5 5
4 4 4 4 4 4 4 4 3 3 3 4 4 4 4 4 4 5 5 5
1 1 1 1 1 1 1 1 1 3 1 1 1 1 1 1 1 2 5 5
1 1 1 1 1 1 1 1 1 3 1 1 1 1 1 1 1 1 2 2
1 1 1 1 1 1 1 1 1 3 1 1 1 1 1 1 1 1 6 1
6 1 1 1 1 1 1 1 1 3 1 1 1 1 1 1 1 1 1 1